8-5
.S.TT..C
.O.TT..C
....T..T
..@....C
C......S
